11111111111111111111111111
1PC00E00010000000000000001
10000000010000000000000001
1000000000000000C000000001
11111111111111111111111111
