11111111111111111111111111
10C00E00010000000000000001
10010000010000000000000001
1110000000000000C000000001
1111000000000000000000P001
11111111111111111111111111
